NO ./img/eagle.xpm
SO ./img/wood.xpm
WE ./img/eagle.xpm
EA ./img/mossy.xpm

F 100,100,0
C 155,0,0

11111111111111111111111111111
10000000001100000000000000001
10110000011100000000000010001
10010000000000000000000010001
10110000011100000000000010001
10000000001100000111011110001
11110111111111011100000010001
11110111111111011101010010001
11000000110101011100000010001
10000000000000001100000010001
10000000000000001101010010001
11000000110101000000000000001
11110111110101000000001000001
10000000001100000100000010001
10000000000000001000000001001
10000000001000010000000001001
10000000001101000000E10000001
10000000000100000000000000001
11111111111111111111111111111
