NO ./img/eagle.xpm
SO ./img/eagle.xpm
WE ./img/eagle.xpm
EA ./img/eagle.xpm

F 200,200,0
C 255,0,0

11111111111111111111111111111
10101010101010101010101010101
10P0P0P0P0P0P0P0P0P0P0P0P0P01
10101010101010101010101010101
10P0P0P0P0P0P0P0P0P0P0P0P0P01
10101010101010101010101010101
10P0P0P0P0P0P0P0P0P0P0P0P0P01
10101010101010101010101010101
1EP0P0P0P0P0P0P0P0P0P0P0P0P01
10101010101010101010101010101
11111111111111111111111111111