NO ./img/hp_ron.xpm
SO ./img/hp_hermione.xpm
WE ./img/hp_rogue.xpm
EA ./img/hp_harry.xpm

F 200,200,0
C 255,0,0

11111
10001
10N01
10001
11111