NO ./img/eagle.xpm
SO ./img/mossy.xpm
WE ./img/wall_1.xpm
EA ./img/wood.xpm

F 100,100,0
C 155,0,0

        1111111111111111111111111
        1000000000110000000000001
        10110000011100000000000N1
        1001000000000000000000001
111111111011000001110000000000001
100000000011000001110111111111111
11110111111111011100000010001
11110111111111011101010010001
11000000110101011100000010001
10000000000000001100000010001
10000000000000001101010010001
1100000111010101111101101000111
11110111 1110101 101111000001
11111111 1111111 111111111111
