NO ./img/eagle.xpm
SO ./img/eagle.xpm
WE ./img/eagle.xpm
EA ./img/eagle.xpm

F 0,0,0
C 255,255,255

111111
100001
100E01
100001
111111
