NO ./img/MAX_VERSTAPPEN.xpm
SO ./img/sanic.xpm
WE ./img/MAX_VERSTAPPEN.xpm
EA ./img/sanic.xpm

F 255,255,255
C 255,255,255

111111111111
100000000001
100000000001
100000000001
10000N000001
100000000001
100000000001
100000000001
111111111111
