NO ./img/patrick.xpm

SO      ./img/patrick.xpm

WE              ./img/patrick.xpm









EA                                          ./img/patrick.xpm



F   184,113,39

C                       51,198,227












        11111
        10001
        10S01
        10001
        11111